LLLLLLLLL#AAAAAAAAA#LLLLLLLLL#AAAAAAAAA#
LLLLLLLLL#AAAAAAAAA#LLLLLLLLL#AAAAAAAAA#
LLLLLLLLL###########LLLLLLLLL###########
E######################################E
WWWWWWWWW#TTTTTTTTT#WWWWWWWWW#TTTTTTTTT#
WWWWWWWWW#TTTTTTTTT#WWWWWWWWW#TTTTTTTTT#
WWWWWWWWW#TTTTTTTTT#WWWWWWWWW#TTTTTTTTT#
#######################################E
PPPPPPPPPP#LLLLLLLL#PPPPPPPPPP#LLLLLLLL#
PPPPPPPPPP#LLLLLLLL#PPPPPPPPPP#LLLLLLLL#
#######################################X
PPPPPPPPPP#AAAAAAAA#PPPPPPPPPP#AAAAAAAA#
PPPPPPPPPP#AAAAAAAA#PPPPPPPPPP#AAAAAAAA#
PPPPPPPPPP#AAAAAAAA#PPPPPPPPPP#AAAAAAAA#
PPPPPPPPPP#AAAAAAAA#PPPPPPPPPP#AAAAAAAA#