####################
LLLLLLLLL#AAAAAAAAA#
LLLLLLLLL#AAAAAAAAA#
LLLLLLLLL###########
WWWWWWWWW#TTTTTTTTTT
####################