X###################
LLLLLLLLL#AAAAAAAAA#
LLLLLLLLL#AAAAAAAAA#
LLLLLLLLL###########
WWWWWWWWW#TTTTTTTTT#
WWWWWWWWW#TTTTTTTTT#
WWWWWWWWW#TTTTTTTTT#
####################
PPPPPPPPPP#LLLLLLLL#
PPPPPPPPPP#LLLLLLLL#
PPPPPPPPPP#AAAAAAAA#
PPPPPPPPPP#AAAAAAAA#
PPPPPPPPPP#AAAAAAAA#
PPPPPPPPPP#AAAAAAAA#
##########E#########